1111111111111
1E01C000000C1
10000M1111M01
1P0011C000001
1111111111111