1111111111111111111111111111111111
1P0000000MMMMMMMMMMMMMM00000000001
1000000000000000000000000000001111
100C00CC0CCCCC0CC000000CCCCCCC1C01
1001111111111111111111111111111101
1E00000000000000000000000000000001
1111111111111111111111111111111111