         




111111
1E0001
101001           
10MMC1     
1P0001   
111111
 

           
