1111111111111111111111111111111111
1E0000000M0000C00000C0000M00000001
101001C100100000101001000000010101
101001C01010M01000100100000C010101
1P0000000C00C0000000000000M00000C1
1111111111111111111111111111111111