
111111
1P00E1
111111
        
