


1111111             
1P10C01                            
1111111                                                                         



            
             



                      


        
